.........................
...p.....................
.........................
...w...w...w.www.w...w...
...w...w...w..w..ww..w...
....w.w.w.w...w..w.w.w...
....w.w.w.w...w..w..ww...
.....w...w...www.w...w...
.........................
.........................
wwwwwwwwwwwwwwwwwwwwwwwww